13128.4284263 342722.674299 -0.983973260743 141 141 142 0.035726 -0.009187 -0.999319 1
13112.2045408 342729.000088 -0.718315925435 99 100 96 -0.685725 0.172577 -0.707106 2
13111.9161062 342723.987959 -0.904423242004 170 170 164 0.021311 -0.019281 -0.999587 1
13109.5505419 342726.360533 -2.60675355253 145 145 149 0.212418 0.971594 -0.104324 0
13116.5686418 342722.390735 -1.02850386371 149 150 149 -0.000981 0.004907 -0.999987 2
13087.9713846 342730.218746 -0.787411014207 78 80 81 -0.998002 -0.059943 0.019981 1
13120.1008016 342721.655757 -1.03075548507 124 127 127 0.025269 -0.009097 -0.999639 1
13115.6592319 342722.230969 -1.18733378533 190 189 188 -0.998482 -0.054839 0.005173 1
13120.0075682 342732.42333 -1.19441245614 113 111 108 0.999916 0.010944 0.006965 1
13112.5130157 342729.158712 -0.9012457408 140 141 144 0.861942 0.036999 -0.505655 1
13118.3966802 342722.115604 -1.03167933715 175 176 175 0.038073 -0.015435 -0.999156 1
13118.5402131 342731.600554 -3.12063343923 152 154 157 0.97843 -0.206415 -0.008163 3
13100.474746 342725.749243 -2.4295841151 178 179 184 -0.053132 -0.448216 0.892345 0
13135.2896577 342729.638736 -0.81659065539 52 52 52 0.290754 0.657007 -0.69556 1
13105.1383694 342726.220271 -0.937470816821 148 151 150 -0.065071 0.030935 -0.997401 1
13117.6253575 342733.111856 -1.20672367391 154 154 155 0.999261 0.037766 -0.007145 1
13114.3548103 342720.929182 -0.39570635789 80 79 74 0.159433 -0.012438 -0.98713 0
13094.2514535 342736.982229 -0.900837570696 20 20 20 -0.131331 0.049106 -0.990122 1
13108.3006994 342734.785942 -2.10537953257 95 95 91 0.66425 -0.247713 -0.705273 3
13135.5247854 342728.016785 -0.572277612737 65 66 78 -0.058202 -0.028572 -0.997896 1
13108.5288043 342732.911338 -1.05833643452 85 85 87 0.755513 0.026632 -0.654592 2
13119.1057752 342731.432536 -3.31406121158 199 199 190 0.008937 -0.006951 0.999936 3
13115.8348031 342722.182908 -0.957104125508 133 136 128 -0.998905 -0.042441 0.019668 1
13108.6478551 342724.996833 -0.909717012916 145 151 152 0.013482 0.048743 -0.99872 1
13111.4681367 342730.10711 -0.830235727335 73 73 69 -0.988815 -0.007839 -0.148938 2
13118.1414229 342731.807986 -1.24670877435 173 170 169 0.989088 -0.104176 -0.104176 1
13118.8121045 342731.805704 -2.1793245362 224 83 83 0.153803 0.026203 0.987754 3
13119.4023134 342721.405135 -1.0094684825 195 199 199 0.027508 0.01732 -0.999471 1
13110.8335756 342732.647887 -2.56860139154 144 141 145 0.16977 -0.985126 0.026563 3
13134.3275176 342728.941658 -0.357594923617 124 118 111 0.014953 0.004984 -0.999876 1
13110.8233576 342724.650609 -0.768045770374 72 74 69 -0.185871 -0.015008 -0.98246 1